1111111111
1010000001
1001100101
1100000101
1111111111